addition|сложение|[əˈdɪʃn]
algebra|алгебра|[ˈæl.dʒə.brə]
almanac|альманах|[ˈɔːl.mə.næk]
angle|угол|[ˈæŋɡl]
annotation|аннотация|[ˈæn.ə.teɪt]
approximately|приблизительно|[əˈprɒksɪmətli]
atlas|атлас|[ˈæt.ləs]
attendance|посещаемость|[əˈten.dəns]
audience|аудитория; слушатели|[ˈɔːdiəns]
auditorium|аудитория; зал|[ˌɔː.dɪˈtɔː.ri.əm]
author|автор|[ˈɔːθə(r)]
bell|звонок|[bel]
binding|переплет|[ˈbaɪn.dɪŋ]
biology|биология|[baɪˈɒlədʒi]
blackboard,  chalkboard|доска|[ˈblæk.bɔːd] [ˈtʃɔːk.bɔːd]
book|книга|[bʊk]
booklet|брошюра; буклет|[ˈbʊk.lət]
bookmark|закладка|[ˈbʊk.mɑːk]
braces|фигурные скобки|[breɪs]
brackets|скобки|[ˈbræk.ɪt]
break, recess|перемена; перерыв|[breɪk] [rɪˈses]
cafeteria|столовая|[ˌkæf.əˈtɪə.ri.ə]
chalk|мел|[tʃɔːk]
chapter|глава|[ˈtʃæptə(r)]
chemistry|химия|[ˈkemɪstri]
children's book|детская книга|[ˈtʃɪl.drəns] [bʊk]
class|класс; занятия|[klɑːs]
classroom|классная комната|[ˈklɑːsruːm]
college|колледж|[ˈkɒlɪdʒ]
common denominator|общий знаменатель|[ˈkɒmən] [dɪˈnɒm.ɪ.neɪ.tər]
computer science|информатика|[kəmˈpjuːtə(r)] [ˈsaɪəns]
contents|содержание; оглавление|[kənˈtent]
copybook, notebook|тетрадь|[ˈkɒp.i.bʊk] [ˈnəʊt.bʊk]
course|курс|[kɔːs]
cover|обложка|[ˈkʌvə(r)]
crayon|цветной карандаш|[ˈkreɪ.ɒn]
cube root|кубический корень|[kjuːb] [ruːt]
dean|декан|[diːn]
dean's office|деканат|[diːns] [ˈɒfɪs]
decimal fraction|десятичная дробь|[ˈdes.ɪ.məl] [ˈfræk.ʃən]
decimal point|десятичная точка|[ˈdes.ɪ.məl] [pɔɪnt]
degree|ученая степень|[dɪˈɡriː]
denominator|знаменатель|[dɪˈnɒm.ɪ.neɪ.tər]
department|отдел|[dɪˈpɑːtmənt]
dictionary|словарь|[ˈdɪkʃənri]
difference|разность|[ˈdɪfrəns]
diploma|диплом|[dɪˈpləʊ.mə]
division|деление|[dɪˈvɪʒn]
drama|драма|[ˈdrɑːmə]
easel|мольберт|[ˈiː.zəl]
economics|экономика|[ˌiː.kəˈnɒm.ɪks]
encyclopedia|энциклопедия|[ɪnˌsaɪ.kləˈpiː.di.ə]
English|английский язык|[ˈɪŋ.ɡlɪʃ]
enrollment|поступление|[ɪnˈrəʊlmənt]
epilogue|эпилог|[ˈep.ɪ.lɒɡ]
equality|равенство|[ɪˈkwɒl.ɪ.ti]
equals|равняться|[ˈiː.kwəl]
equation|уравнение|[ɪˈkweɪ.ʒən]
eraser, rubber|ластик; резинка|[ɪˈreɪ.zər] [ˈrʌbə(r)]
essay|очерк; эссе|[ˈeseɪ]
exam|экзамен|[ɪɡˈzæm]
fable|басня|[ˈfeɪ.bl̩]
faculty|факультет|[ˈfæk.əl.ti]
fairy tale|сказка|[ˈfeə.ri] [teɪl]
fantasy|фантастика|[ˈfæn.tə.si]
fiction|художественная литература|[ˈfɪk.ʃən]
finals|выпускные экзамены|[ˈfaɪ.nəl]
form|форма|[fɔːm]
fraction|дробь|[ˈfræk.ʃən]
freshman|первокурсник|[ˈfreʃ.mən]
geography|география|[dʒiˈɒɡrəfi]
geometry|геометрия|[dʒiˈɒm.ə.tri]
glue|клей|[ɡluː]
grade, mark|отметка; оценка|[ɡreɪd] [mɑːk]
graduation|окончание учебного заведения|[ˌɡrædʒ.uˈeɪ.ʃən]
group|группа|[ɡruːp]
guide book|путеводитель|[ɡaɪd] [bʊk]
handbook|справочник|[ˈhænd.bʊk]
headmistress|директриса|[ˌhedˈmɪs.trəs]
high school|средняя школа|[haɪ] [skuːl]
higher education|высшее образование|[ˈhaɪ.ər] [ˌedʒuˈkeɪʃn]
history|история|[ˈhɪstri]
homework|домашняя работа|[ˈhəʊmwɜːk]
horror|ужасы|[ˈhɒrə(r)]
illustrate|иллюстрировать|[ˈɪləstreɪt]
improper fraction|неправильная дробь|[ɪmˈprɒp.ər] [ˈfræk.ʃən]
inequality|неравенство|[ˌɪn.ɪˈkwɒl.ə.ti]
infinity|бесконечность|[ɪnˈfɪn.ɪ.ti]
ink|чернила|[ɪŋk]
institute|институт|[ˈɪnstɪtjuːt]
introduction|введение|[ˌɪntrəˈdʌkʃn]
lecture|лекция|[ˈlektʃə(r)]
lecturer|лектор|[ˈlek.tʃər.ər]
legend|легенда|[ˈledʒ.ənd]
length|длина; расстояние|[leŋθ]
less or equal|мельше или равно|[les] [ɔː(r)] [ˈiːkwəl]
lesson|урок; занятие|[ˈlesn]
literature|литература|[ˈlɪtrətʃə(r)]
lodgings|сдаваемая комната|[ˈlɒdʒ.ɪŋ]
mathematical sign|математический знак|[ˌmæθˈmæt.ɪks] [saɪn]
maths|математика|[mæθs]
memoir, reminiscence|мемуары|[ˈmem.wɑːr] [ˌrem.ɪˈnɪs.əns]
minus|минус|[ˈmaɪ.nəs]
more or equal|больше или равно|[mɔː(r)] [ɔː(r)] [ˈiːkwəl]
multiplication|умножение|[mʌltɪplɪˈkeɪʃn]
multiplication table|таблица умножения|[mʌltɪplɪˈkeɪʃn] [ˈteɪbl]
music|музыка|[ˈmjuːzɪk]
myth|миф|[mɪθ]
negative sign|знак отрицания|[ˈneɡətɪv] [saɪn]
nonfiction|документальная литература|[ˌnɒnˈfɪk.ʃən]
not equal|не равный|[nɒt] [ˈiːkwəl]
notes|заметка|[nəʊt]
novel|роман|[ˈnɒvl]
number|число|ˈnʌmbə(r)]
numerator|числитель|[ˈnjuː.mə.reɪ.tər]
dormitory|общежитие|[ˈdɔː.mɪ.tər.i]
pamphlet, booklet|брошюра|[ˈpæm.flət] [ˈbʊk.lət]
paper|бумага|[ˈpeɪpə(r)]
paper clip|скрепка для бумаг|[ˈpeɪpə(r)] [klɪp]
paragraph|абзац|[ˈpær.ə.ɡrɑːf]
parallel|параллельный|[ˈpærəlel]
parentheses|круглые скобки|[pəˈren.θə.siːz]
passage|отрывок|[ˈpæsɪdʒ]
pen|ручка|[pen]
pencil|карандаш|[ˈpensl]
pencil sharpener|точилка|[ˈpensl] [ˈʃɑː.pən.ər]
percent|процент|[pəˈsent]
perpendicular|перпендикуляр|[ˌpɜː.pənˈdɪk.jʊ.lər]
physics|физика|[ˈfɪzɪks]
plus|плюс|[plʌs]
pocket edition|карманное издание|[ˈpɒkɪt] [ɪˈdɪʃn]
poem|стихотворение|[ˈpəʊɪm]
poetry|поэзия|[ˈpəʊətri]
preface|предисловие|[ˈpref.ɪs]
Primary School|начальная школа|[ˈpraɪməri] [skuːl]
principal, headmaster|директор|[ˈprɪn.sɪ.pəl] [ˌhedˈmɑː.stər]
problem|задача|[ˈprɒbləm]
professor|профессор|[prəˈfesə(r)]
prologue|пролог|[ˈprəʊ.lɒɡ]
prose|проза|[prəʊz]
psychology|психология|[saɪˈkɒl.ə.dʒi]
pupil|ученик|[ˈpjuːpl]
quotient|частное (при делении)|[ˈkwəʊ.ʃənt]
reference book|справочник|[ˈrefrəns] [bʊk]
register|регистр|[ˈredʒɪstə(r)]
remainder|остаток|[rɪˈmeɪn.dər]
rhyme|рифма|[raɪm]
right angle|прямой угол|[raɪt] [ˈæŋɡl]
ruler|линейка|[ˈruːlə(r)]
saga|сага|[ˈsɑː.ɡə]
satire|сатира|[ˈsæt.aɪər]
school|школа|[skuːl]
science fiction|научная фантастика|[ˈsaɪəns] [ˈfɪk.ʃən]
scissors|ножницы|[ˈsɪzəz]
series of numbers|ряд чисел|[ˈsɪəriːz] [əv] [ˈnʌm.bər]
sociology|социология|[ˌsəʊ.siˈɒl.ə.dʒi]
sonnet|сонет|[ˈsɒn.ɪt]
sophomore|второкурсник|[ˈsɒf.ə.mɔːr]
square brackets|квадратные скобки|[skweə(r)] [ˈbræk.ɪt]
square root of|корень квадратный из|skweə(r)] [ruːt] [əv]
stapler|степлер|[ˈsteɪ.plər]
story|рассказ|[ˈstɔːri]
student|студент|[ˈstjuːdnt]
subtraction|вычитание|[səbˈtræk.ʃən]
sum|сумма|[sʌm]
table|стол; таблица|[ˈteɪbl]
teacher|преподаватель|[ˈtiːtʃə(r)]
technical literature|техническая литература|[ˈteknɪkl] [ˈlɪtrətʃə(r)]
term, semester|четверть; семестр|[tɜːm] [sɪˈmes.tər]
test|тест|[test]
text|текст|[tekst]
textbook|учебник|[ˈtekst.bʊk]
title|заглавие|[ˈtaɪtl]
transfer|перевод, передача|[trænsˈfɜː(r)]
translation|перевод|[trænsˈleɪʃn]
university|университет|[ˌjuːnɪˈvɜːsəti]
volume|том|[ˈvɒljuːm]
writer|писатель|[ˈraɪtə(r)]
